10000000000000001
10000000000000001
10000000000000001
10000000000000001
10101010101010101
11111111111111111